1111111111111111111111111111111111111111111111111
1P00000000000000000000000000000000000000000000001
100C000000000000000000000000000000000000000000001
100E000000000000000000000000000000000000000000001
1000000000000000000000000000000000000000000000001
1000000000000000000000000000000000000000000000001
1000000000000000000000000000000000000000000000001
1000000000000000000000000000000000000000000000001
1000000000000000000000000000000000000000000000001
1111111111111111111111111111111111111111111111111