11111110111111
10000000000001
10000000000000
00000000000001
10000E00000001
10000000000001
10000CCC0000P1
11111110111111