111111
1P0001
100CC1
10C111
10CE01
111111